1230000000
0400000000
0560000000
0780000000
0000000000
0000000000
0000000000
0000000000
0000000000
0000000000